Name	title	coding
t3_qprgxb	Recommendations for U3 electives?	c
t3_qpqlpc	Difficulty to find a date at McGill :/	o
t3_qpo7y6	How many classes can you fail before you get kicked out?	c
t3_qpo74y	Grading at McGill	c
t3_qpma8y	How long does it take to get official transcripts?	o
t3_qplrde	Comp 598 students: Should res provide better vegetarian food options?	f
t3_qpkoxu	"Anyone else getting constant ""Unexpected Server Response"" on mycourses when trying to access documents?"	o
t3_qpkcxp	Peculiar microwave ?	f
t3_qpjb3c	Which advisor should I contact to talk about switching faculties?	o
t3_qpishs	Fast pass sticker??	o
t3_qphe5x	Starting a band	o
t3_qph27r	Struggling with Language at Work	o
t3_qpdtsm	International student insurance coverage for consultation with a doctor outside McGill	r
t3_qpd7vg	Is there free COVID testing for McGill students?	o
t3_qp884q	My only source for a reference doesn't want to be a reference - what to do?	o
t3_qp87j2	On-campus study spots with nice outside view ?	o
t3_qp6gu4	good news monday	o
t3_qp5rs9	COMP 252	c
t3_qp5adh	Going less than full time as an intl student for personal reasons?	r
t3_qp3xao	"To full time students/part time workers in the Life Sciences program, what should be the maximum amount of hours you allot for work without compromising your studies??"	r
t3_qp0a8e	Anyone willing to share psyc 213 notes?	c
t3_qos56x	Quick SOCI235 Questions	c
t3_qoet9m	Anyone done the government's free french courses that you get paid to do?	o
t3_qodyxq	Wellness hub replacement?	o
t3_qo9l6v	Is Submitting a Final Exam Paper to a Journal Problematic?	o
t3_qo77a3	CodeJam Updates!	o
t3_qo1vab	Winter 2022 Exchange Reinstatement: Australia	r
t3_qnu7f4	Where are some quiet areas of Montreal?	o
t3_qnu45p	Pottery stations in montreal	o
t3_qnu3xn	Any fans of Better Call Saul?	o
t3_qnrj9f	textbook requirements for poli classes?	c
t3_qnotut	Positive COVID Case at CHEM 222 midterm 2/Lab	o
t3_qnosog	Anyone been to Gerts bar recently?	o
t3_qnm80d	birth control @ wellness hub	o
t3_qnlnww	Question about PHGY212 Final	c
t3_qngvlt	Geog216 midterm two	c
t3_qnfz1o	Here's a nice secret study spot - can anyone guess where it is?	o
t3_qnfh8q	caged squirrel in leacock I'd like to know if it's ok	o
t3_qncnpo	Question about Richard Roy	o
t3_qnap8i	How to study for ANAT 261	c
t3_qn8xww	Hot water on campus?	o
t3_qn2l92	Study spots in 2001 av McGill College	o
t3_qn2tjp	midterm grade and course grade	c
t3_qmuiwp	Unwell Woman in Burnside ground staircase	o
t3_qmsx3x	atm near campus	o
t3_qmslx9	Where can I find a poppy? (2021)	f
t3_qmqm93	Is 3.7 GPA good for a Psychology major?	o
t3_qmpl37	LOST MY KEYS NEAR MCGILL details in comments please return if found it is a very sentimental item.	o
t3_qmn8ht	Macdonald Engineering Evacuated	o
t3_qmgzy4	BIOL215 midterm thoughts?	c