Name	title	coding
t3_qpuhjr	"Have four courses, planning to disc one tonight. Would I become a part time student?"	c
t3_qptic5	What kind of phone do you use? (Survey for a class)	o
t3_qpr2og	"Guys , what’s the best website/app to find apartments for rent for students?"	o
t3_qpqth4	CS electives	c
t3_qpljyy	What's the course availability usually like for the summer semesters?	c
t3_qpl6dx	Work-study program	c
t3_qpl3jr	Is graduate course withdrawal deadline today?	o
t3_qphn14	Chance of concentration mechanical Beng to Soen	c
t3_qp5j44	Concordia or uwindsor	o
t3_qp4jb2	Canadian citizen ship	o
t3_qoumus	Comm 215	o
t3_qou8a7	COMM 225 Midterm 2	c
t3_qotj9a	Study permit	o
t3_qo4ris	DISC on DISC date?	c
t3_qo26js	Permanent code international student.	r
t3_qo0c3s	BTM salary upon graduation?	o
t3_qnqvld	"How Prof Aimaan Hanna knows everyone name by face, even though all new students never met him ?"	o
t3_qnqr6v	Conditional Offer of Admission	c
t3_qnp9ug	Anyone down to play online games this weekend?	o
t3_qne2cy	Just submitted my application for fall 2022!!!	c
t3_qndfs9	Is there a limit to how many DISC you can have?	o
t3_qncmqz	Anyone know any good psychoanalysts around?	o
t3_qnccmc	Study Permit rant	r
t3_qnb3i5	Is a tutor allowed to give a quiz after stating no quiz would be given?	c
t3_qn0dnv	Self-study source for MATH and PHYS	c
t3_qn079w	Soccer Tournament	o
t3_qmry9i	"Relevent post, this scammer is around Concordia (St. Catherines just west of rue Guy)"	c
t3_qmopar	Survey for our Statistics Class! :)	o
t3_qmnn6h	Hard course load for winter?	c
t3_qmdxoa	Gown	o
t3_qm78z3	Winter 2022 Schedule Advice	c
t3_qm5my8	looking for paid tutorials	c
t3_qm2jtm	Absolute professor dilemma-&gt; Anthony Noce or Anca Alecsandru	o
t3_qm1wq9	Wheelchair	o
t3_qm1eee	Teamwork with 10 teammates	o
t3_qlyd20	CAQ and Study Permit	r
t3_qly38g	COURSE QUESTION	c
t3_qlvcl8	How is Nicolas Lepage-Saucier as a teacher?	o
t3_qlcvar	btm 200 online	o
t3_ql7n1t	acco 230 midterm	c
t3_ql6cz7	Grad preparation Winter 2022	r
t3_ql2ywv	Does the FG building connect to the John Molson building?	o
t3_qktjdp	DISC classes - As an international student	o
t3_qkrxur	Concordia Continuing Education worth it?	o
t3_qkovqw	I’m an industrial engineer working in an automation / robots company . The work environment is dominated by mechanical/electrical/mechatronics engineers and the only way to grow within the company it’s learning technical (robotics - mechanical) skill . Any relevant masters degree recommended ?	o
t3_qklu8l	Organic chemistry II with Marco Paladino	o
t3_qk6py8	Pre requisite courses to transfer to John Molson	c
t3_qk28ih	Any international students ever received Gardasil 9?	r
t3_qjz0pr	Learn to become bilingual on the job	o
t3_qjyal1	Concordia Lizard Lounge (Win gift cards)	o